0000000000000000000000000
0000000000000000000000000
0000000000000000000000000
0000003330000000000000000
0000003130000000000000000
0000003833300000000000000
0000003848300000000000000
0000003338333000000000000
0000000038483000000000000
0000000033383330000000000
0000000000384830000000000
0000000000333833300000000
0000000000003848300000000
0000000000003338333000000
0000000000000038423000000
0000000000000033333000000
0000000000000000000000000
0000000000000000000000000
0000000000000000000000000
