0000000000000000000000000
0000000000000000000000000
0000000000000000000000000
0000000000000000000000000
0000000000000000000000000
0000000333333333330000000
0000000388888888830000000
0000000383333333830000000
0000000383888883830000000
0000000383833383830000000
0000000383832383830000000
0000000383838383830000000
0000000383838883830000000
0000000383833333830000000
0000000313888888830000000
0000000333333333330000000
0000000000000000000000000
0000000000000000000000000
0000000000000000000000000
