0000000000000000000000000
0000000000000000000000000
0000000000000000000000000
0000000000000000000000000
0000000033333000000000000
0000000033283300000000000
0000000031388330000000000
0000000038838833000000000
0000000033883883300000000
0000000003388388330000000
0000000000338838833000000
0000000000033883883000000
0000000000003388383000000
0000000000000338883000000
0000000000000033333000000
0000000000000000000000000
0000000000000000000000000
0000000000000000000000000
0000000000000000000000000
