0000000000000000000000000
0000000000000000000000000
0333333333333333333333330
0314444444444444444444830
0333333333333333333333830
0384848484848484848484830
0383333333333333333333330
0384444444444444444444830
0333333333333333333333830
0384848484848484848484830
0383333333333333333333330
0384444444444444444444830
0333333333333333333333830
0384848484848484848484830
0383333333333333333333330
0323333333333333333333330
0333333333333333333333330
0000000000000000000000000
0000000000000000000000000
