0000000000000000000000000
0003330000000000000000000
0003230000000000000000000
0003830000000000000000000
0003830000000000000000000
0003830000000000000000000
0003830000000000000000000
0003830000000000000000000
0003130000000000000000000
0003330000000000000000000
0000000000000000000000000
0000000000000000000000000
0000000000000000000000000
0000000000000000000000000
0000000000000000000000000
0000000000000000000000000
0000000000000000000000000
0000000000000000000000000
0000000000000000000000000
