0000000000000000000000000
0000000000000000000000000
0000000000000000000000000
0000000000000000000000000
0000000000000000000000000
0000000000000000000000000
0000000000333333000000000
0000000000324883000000000
0000000000333383000000000
0000000000000343000000000
0000000000000383000000000
0000000000000313000000000
0000000000000333000000000
0000000000000000000000000
0000000000000000000000000
0000000000000000000000000
0000000000000000000000000
0000000000000000000000000
0000000000000000000000000
