0000000000000000000000000
0000000000000000000000000
0000000000000000000000000
0000000000000000000000000
0000000000033300000000000
0000000003331333300000000
0000000003888888300000000
0000000003833438300000000
0000000003888888300000000
0000000003338343300000000
0000000000388483000000000
0000000000383383000000000
0000000000388283000000000
0000000000333333000000000
0000000000000000000000000
0000000000000000000000000
0000000000000000000000000
0000000000000000000000000
0000000000000000000000000
